#####################
#         #         #
# ## #### # #### ## #
# ## #XX# # #XX# ## #
# ## #### # #### ## #
#                   #
# ## # ####### # ## #
#    #    #    #    #
#### #### # #### ####
   # #         # #   
#### # ##---## # ####
       #XXXXX#       
####   #######   ####
   #             #   
####   #######   ####
#         #         #
# ### ### # ### ### #
#   #           #   #
### # # ##### # # ###
#     #   #   #     #
# ####### # ####### #
#                   #
#####################