########################################
#                                      #
# ##### ##### #####  ##### ##### ##### #
#     # #                              #
#     #                                #
#     # #                              #
#     # ###                            #
#                                      #
#     #####                            #
#                                      #
#                                      #
#                                      #
#                                      #
#                                      #
########################################